NO ./src/textures/regular_tiles.xpm
SO ./src/textures/regular_tiles.xpm
EA ./src/textures/green_tiles.xpm

F 245,245,220
C 0,39,47
WE ./src/textures/green_tiles.xpm

            1111111111111111111111111
            1000000000110000000000001
           11011000001110000000000001
11111111111100100000000000000000000111111111
1111111110110000011100000000000011111
100000000011000001110111111111111
11110111111011011100000010001
1111D1111111110111010100100011
110000000001010111000000100001
1000S0001000000011000000100011
10000000000000001101010010001
1100000111010101111101111000111
11110111 1110101 101111010001
11111111 1111111 111111111111
