NO ./src/textures/regular_tiles.xpm
SO ./src/textures/regular_tiles.xpm
EA ./src/textures/green_tiles.xpm


WE ./src/textures/green_tiles.xpm
C 000000,39,47
F 245,245,220


            1111111111111111111111111
            10000000001100000000000011
           11011000001110000000000001
11111111111100100000000000000000000111111111
1111111110110000011100000000000011111
100000000011000001110111111111111
11110111111011011100000010001
111101111111110111010100100011
110000000001010111000000100001
10000N0010000010011000000100011
100000000000000011010100100011
1100000111010101111101111000111
11110111 1110101 101111010001
11111111 1111111 111111111111
