NO ./src/textures/wall_north.xpm
SO ./src/textures/wall_south.xpm
EA ./src/textures/wall_east.xpm
WE ./src/textures/wall_west.xpm

C 0,39,47
F 225,0,5

1111111111111111111111111
1111000000110000000111
1111100000111000000011
1011000000000000000001          
1111D10000000001100001
1000000000110000011111  
1000S000000000000000111
10000000000100001000001
10000000000000000001111
1111100000000111111111
1111111111111111111111 