NO ./src/textures/regular_tiles.xpm
SO ./src/textures/regular_tiles.xpm
EA ./src/textures/green_tiles.xpm
WE ./src/textures/green_tiles.xpm

C 0,39,47
F 245,245,220

11111
1DN01
11111
