NO ./src/textures/wall_north.xpm
SO ./src/textures/wall_south.xpm
EA ./src/textures/wall_east.xpm
WE ./src/textures/wall_west.xpm

C 0,39,47
F 225,0,5

111111111111111111111
1111000000110000000111
1111100000111000000011
1011000000000000000001          
11D1110000000001100001
1010000000110000011111  
1100S0000000000000001111
 11100000000001000010001
110000000000000000011111
1111100000000111111111
1111111111111111111111 