NO ./src/textures/regular_tiles.xpm
SO ./src/textures/old_tiles.xpm
EA ./src/textures/cobblestone.xpm
WE ./src/textures/green_stone.xpm

C 0,0,128
F 245,245,220

1111111111111111111111111111111111111111
1010000000001000000000N00000000000000001
101011111110111D1110101111101111D1101111
1010000000000000000010000010001000100001
1011111110111111111111111011101011101111
1010000010100000000000000010000010001001
1010111000101111111111101111110110111011
1010D01010101000000000100000000000000011
1010101010101011111110111110111111101111
1111111111111111111111111111111111111111