NO ./src/textures/wall_north.xpm
SO ./src/textures/wall_south.xpm
EA ./src/textures/wall_east.xpm
WE ./src/textures/wall_west.xpm

C 0,39,47
F 225,0,5

            1111111111111111111111111
            1000000000110000000000001
           11011000001110000000000001
        111100100000000000000000000111111111
1111111110110000011100000000000011111
100000000011000001110111111111111
11110111111011011100000010001
1111D111111111011101010010001
11000000110101011100000010001
1000S000000000001100000010001
10000000000000001101010010001
1100000111010101111101111000111
11110111 1110101 101111010001
11111111 1111111 111111111111